↓→→→→→↓↓
↓↓↑↑↑↓↓↓
↓↓↓↓↑↓↓↓
↓↓↓↓↓↓↓↓
↓↓↓↓→↓↓↓
→→→→→↓↓↓
→→→→→→↓↓
→→→→→→→→
